abad	abadnya	-nya
ada	mengada-adakan	meN-;-kan;R-penuh
adeni	adeni
adik	adik-adik	R-penuh
afgan	afgan
akhlak	akhlaknya	-nya
aki	akinya	-nya
alang	teralang	ter-
alat	memperalat	meN-;per-
alih	dialihkah	di-;-kah
amin	mengaminkannya	meN-;-kan;-nya
ampuh	mengampuhkan	meN-;-kan
ampun	terampuninya	ter-;-i;-nya
ancam	ancam-mengancam	meN-;R-penuh
andil	berandil	ber-
anggap	dianggapnya	di-;-nya
anggar	teranggar-anggar	ter-;R-penuh
angguk	dianggukkannya	di-;-kan;-nya
angkat	diangkatkan	di-;-kan
antar	pengantar	peN-
antarklub	antarklub
anti-rezim	anti-rezim
antigen	antigen
apit	mengapit	meN-
apresiasi	terapresiasinya	ter-;-nya
arak	diaraknya	di-;-nya
archi	archi
asah	diasah	di-
atrium	atrium
australia-indonesia	australia-indonesia
babak	membabak	meN-
baca	pembacaan	peN--an
badari	badari
baik	pembaik	peN-
baik	per-baikan	per--an
bak	bakkah	-kah
banding	membanding-bandingkan	meN-;-kan;R-penuh
bangun	kebangunan	ke--an
bangun	membanguninya	meN-;-i;-nya
banting	bantingan	-an
banyak	banyak-banyaknya	-nya;R-penuh
barat	baratlah	-lah
barung	barung-barung	R-penuh
bawa	dibawanyalah	di-;-nya;-lah
bayang	bayangnya	-nya
bayang	dibayangkan	di-;-kan
beber	membebernya	meN-;-nya
beda	berbeda-bedanya	ber-;-nya;R-penuh
bedil	bedil-bedilan	-an;R-penuh
bekuk	pembekuk	peN-
bela	kubela	ku-
belah	membelahnya	meN-;-nya
belikan	belikanlah	-lah
belit	berbelit-belit	ber-;R-penuh
bencol	bencol
bentur	berbenturannya	-an;-nya
berangus	diberangus	di-
beritahu	beritahukan	-kan
beritahu	diberitahukanlah	di-;-kan;-lah
berkat	kauberkati	kau-;-i
besar	besarkan	-kan
beting	terbeting	ter-
biak	kubiak	ku-
biasa	terbiasalah	ter-;-lah
biaya	biayaan	-an
biji	membiji	meN-
bina	binalah	-lah
bina	pembinaannya	-nya;peN--an
binar	berbinar-binar	ber-;R-penuh
bisik	dibisikkan	di-;-kan
bisik	membisiki	meN-;-i
bisnis	membisniskan	meN-;-kan
blokir	blokirlah	-lah
budak	budak-budaklah	-lah;R-penuh
budi	sebudi	se-
bungkus	membungkus	meN-
cacah	mencacah	meN-
candai	candai
cangkok	pencangkok	peN-
cantis	cantis
cap	bercap	ber-
capuk	bercapuk-capuk	ber-;R-penuh
carter	dicarter	di-
cawe	cawe-cawe	R-penuh
cegah	pencegahannya	-nya;peN--an
cemas	secemas	se-
cendekiawan	cendekiawannya	-nya
cerdas	secerdas	se-
cering	cering-cering	R-penuh
cerna	dicerna	di-
cita	mencita	meN-
cium	bercium-ciuman	ber-;R-penuh
coba	mencobai	meN-;-i
culik	culikan	-an
curang	kecurangan	ke--an
daftar	didaftar	di-
dalam	kedalamannya	-nya;ke--an
darah	mendarahi	meN-;-i
datang	datangnya	-nya
datuk	mendatukkan	meN-;-kan
daya	memperdayamu	meN-;per-;-mu
dayung	dayung
debat	mendebat	meN-
debuk	debuk
debut	debutnya	-nya
dekat	didekatilah	di-;-i;-lah
deklarasi	dideklarasikannya	di-;-kan;-nya
dekonsentrasi	dekonsentrasinya	-nya
depan	didepaninya	di-;-i;-nya
dewa	kedewaan	ke--an
disiplin	disiplinnya	-nya
divestasi	didivestasi	di-
donasi	didonasikan	di-;-kan
dongeng	dongengnya	-nya
dongeng	mendongengi	meN-;-i
duduk	kependudukannya	peN-;-nya;ke--an
dukan	dukan
dunia	duniamu	-mu
durhaka	mendurhaka	meN-
edar	beredarnya	ber-;-nya
eksistensi	eksistensinya	-nya
ekspresi	ekspresimu	-mu
elektron	elektronnya	-nya
gadai	penggadaian	peN--an
gantung	digantungkan	di-;-kan
garansi	garansi
gejolak	bergejolaknya	ber-;-nya
gelombang	gelombangnya	-nya
gelut	digelutinya	di-;-i;-nya
gemar	digemari	di-;-i
gemuruh	bergemuruhnya	ber-;-nya
gerak	penggerak	peN-
gigit	bergigit	ber-
gigit	tergigitnya	ter-;-nya
gilir	giliranlah	-an;-lah
goyang	kugoyangkan	ku-;-kan
gubris	digubris	di-
gula	gula-gula	R-penuh
gumul	bergumulan	ber--an
gunung	menggunung	meN-
gurau	gurauannya	-an;-nya
haiku	haiku
hajar	hajarlah	-lah
hak	dihakinya	di-;-i;-nya
hakim	hakimilah	-i;-lah
hamba	kehambaan	ke--an
hampa	menghampakanku	meN-;-kan;-ku
harap	diharapkan	di-;-kan
hilang	hilang
himpit	menghimpitkan	meN-;-kan
hina	hinaan	-an
hindar	hindarkanlah	-kan;-lah
hingga	hinggalah	-lah
hitung	terhitung	ter-
hormat	hormatkah	-kah
ibarat	ibarat
iman	imanlah	-lah
impi	impi
incar	pengincar	peN-
indikasi	diindikasikannya	di-;-kan;-nya
ingat	ingatlah	-lah
ingin tahu	keingintahuan	ke--an
ingsut	ingsut
injak	diinjak-injak	di-;R-penuh
integrasi	integrasi
internal	internal
interogasi	interogasinya	-nya
interpretasi	menginterpretasi	meN-
investigasi	menginvestigasinya	meN-;-nya
iring	beriring	ber-
isi	berisikan	ber--kan
islam	seislam	se-
istana	diistana	di
isteri	isterikah	-kah
jabar	jabar
jadi	menjadi	meN-
jajah	jajahannya	-an;-nya
jajar	disejajarkan	di-;se-;-kan
jalan	jalanan
janggal	janggalnya	-nya
jantung	dijantungnya	di-;-nya
jauh	jauhlah	-lah
jubah	jubahmu	-mu
julang	julang
kacau	mengacau-balaukan	meN-;-kan;R-ritma
kait	dikaitnya	di-;-nya
kakek	kakeknya	-nya
kalah	mengalahkannya	meN-;-kan;-nya
kali	kali-kalian	-an;R-penuh
kalo	kalo
kanak	kanak-kanakku	-ku;R-penuh
kantong	pengantongan	peN--an
kapal	kapalku	-ku
kapu	kapu-kapu	R-penuh
kasih	kukasihi	ku-;-i
kategorisasi	kategorisasi
kawal	pengawalpun	peN-;pun
kayuh	pengayuh	peN-
kekal	kekalkan	-kan
kelip	kelip
kelupas	kelupas
kemarin	kemarinnya	-nya
kemas	kemaslah	-lah
kendara	berkendaralah	ber-;-lah
keras	berkeras-keras	ber-;R-penuh
keras	terkerasnya	ter-;-nya
kerdip	berkerdip	ber-
kerjasama	kerjasamanya	-nya
ketat	ketatlah	-lah
kibar	kibarkan	-kan
kinja	kinja
kira	kira-kiranya	-nya;R-penuh
kirim	dikirimnya	di-;-nya
kisruh	dikisruhkan	di-;-kan
kisruh	mengisruhkan	meN-;-kan
kolaborasi	berkolaborasi	ber-
koloh	koloh-koloh	R-penuh
komoditi	komoditinya	-nya
kompetensi	kompetensi
kondusif	kondusifnya	-nya
konsili	konsilinya	-nya
kontak	mengontakkan	meN-;-kan
konvensi	konvensi
konversi	konversikan	-kan
koordinator	koordinatornya	-nya
koprek	pengoprek	peN-
kpri	kpri
kreativitas	kreativitas
krisis	krisis
kuartal	kuartalnya	-nya
kuasa	kuasai	-i
kudil	kudil
kulit	kulitlah	-lah
kumpal	kumpal
kurung	berkurung	ber-
lacur	lacur
lain	berlain-lain	ber-;R-penuh
laki	berlakilah	ber-;-lah
laman	laman-laman	R-penuh
lambai	dilambaikannya	di-;-kan;-nya
lancar	lancarkan	-kan
landa	melanda	meN-
langgar	berlanggar-langgaran	ber--an;R-penuh
larik	larikanlah	-an;-lah
lebur	dileburkan	di-;-kan
legislasi	legislasinya	-nya
lekat	lekati	-i
lembaga	lembagakan	-kan
lempar	lemparkanlah	-kan;-lah
lempek	berlempek-lempek	ber-;R-penuh
lempem	lempem
lepas	melepasi	meN-;-i
lima	lima
linang	berlinang-linang	ber-;R-penuh
lincah	lincah
lindung	perlindunganmu	-mu;per--an
liter	seliter	se-
lomba	dilombakan	di-;-kan
lumur	lumuran	-an
lunas	pelunas	peN-
luncur	luncurannya	-an;-nya
lurus	luruskanlah	-kan;-lah
mabuk	memabukkanku	meN-;-kan;-ku
macam	macamnya	-nya
mahasiswa	mahasiswanya	-nya
majalah	majalahku	-ku
maju	memaju	meN-
makna	pemaknaan	peN--an
manfaat	memanfaatkan	meN-;-kan
manis	dimanis	di-
marga	bermarga	ber-
masyarakat	masyarakatnya	-nya
mati	matimu	-mu
mayang	dimayang	di-
mewa	mewa
milik	kemilikan	ke--an
mitra	mi-tra
mortir	mortirnya	-nya
mudarat	dimudaratkan	di-;-kan
mulus	mulus
murka	memurkainya	meN-;-i;-nya
nabi	nabi-nya	-Nya
naik	menaikkanku	meN-;-kan;-ku
nalar	penalaranmu	-mu;peN--an
nama	bernama	ber-
nama	dinamakan	di-;-kan
nanti	penantiannya	-nya;peN--an
nomor	nomorku	-ku
nyanyi	nyanyi
open	diopeni	di-;-i
organisasi	organisasilah	-lah
organisasi	terorganisasinya	ter-;-nya
oven	oven
paham	pahamkah	-kah
pajang	kupajang	ku-
pancar	memancarkan	meN-;-kan
pandu	pemandunyalah	peN-;-nya;-lah
panjat	memanjati	meN-;-i
pantul	pantul
pas	paskah	-kah
pascapanen	pascapanen
pasok	memasoknya	meN-;-nya
paten	patenkan	-kan
pecat	pemecatanlah	-lah;peN--an
pegang	berpegangan	ber--an
pendam	terpendam	ter-
pendek	pendek
pentung	pentung-pentungan	-an;R-penuh
peran	berperanan	ber-
percik	pemercik	peN-
periksa	periksalah	-lah
perintah	perintahkanlah	-kan;-lah
perlu	perlumu	-mu
persiku	persiku
petek	petek
petik	petikannya	-an;-nya
picu	terpicunya	ter-;-nya
pikul	dipikul	di-
pikul	kupikul	ku-
pil	pil
pilin	memilin-milin	meN-;R-penuh
pimpin	pemimpinlah	peN-;-lah
pindah	pindahan	-an
pintas	memintasi	meN-;-i
pondok	pondokku	-ku
ponsel	ponsel-ponsel	R-penuh
posisi	posisiku	-ku
potensi	berpotensinya	ber-;-nya
pra	pra
pramusim	pra-musim
praperadilan	praperadilannya	-nya
praregistrasi	praregistrasi
presentasi	presentasikan	-kan
prestise	prestiselah	-lah
produksi	produksinya	-nya
produktif	keproduktifan	ke--an
profesional	keprofesionalan	ke--an
promosi	mempromosi	meN-
protes	protes
psikologis	psikologis
pulih	kepulihan	ke--an
pura	kepura-puraanku	-ku;ke--an;R-penuh
ragam	ragamnya	-nya
ragu	keragu-raguanmu	-mu;ke--an;R-penuh
rajut	terajutnya	ter-;-nya
rakyat	rakyatlah	-lah
ramai	meramai-ramai	meN-;R-penuh
rangkai	kurangkai	ku-
ranjang	ranjangnya	-nya
ranya	ranya
rasuk	rasukan	-an
ratap	ratap
reaksi	bereaksi	ber-
rela	relakan	-kan
relaksasi	direlaksasi	di-
relief	reliefnya	-nya
remah	keremahan	ke--an
rembet	merembet-rembet	meN-;R-penuh
renovasi	merenovasinya	meN-;-nya
revolusi	berevolusi	ber-
rinci	rincinya	-nya
rindu	merindukanmu	meN-;-kan;-mu
ringan	meringani	meN-;-i
ringan	ringanlah	-lah
ringkas	ringkasannya	-an;-nya
risau	risau
roboh	kerobohan	ke--an
rogoh	merogoh	meN-
roh	roh
ronda	rondaanlah	-an;-lah
rumbai	rumbai-rumbai	R-penuh
rute	rute
rutin	kerutinan	ke--an
sabar	kesabaranmu	-mu;ke--an
sakit	sakit-sakitan	-an;R-penuh
saksi	bersaksikan	ber--kan
salur	salurkan	-kan
sama	menyamakan	meN-;-kan
sanggup	kesanggupanku	-ku;ke--an
sanggup	sesanggup	se-
santap	bersantap	ber-
saring	penyaring	peN-
sebut	menyebutkannya	meN-;-kan;-nya
seluruh	seluruh
semangat	menyemangatiku	meN-;-i;-ku
sembah	disembahnya	di-;-nya
sembahyang	sembahyang
sembunyi	disembunyikannya	di-;-kan;-nya
sensori	sensori
sentuh	kesentuhan	ke--an
seret	diseretnya	di-;-nya
serta	beserta	ber-
seruput	menyeruputnya	meN-;-nya
seruput	seruput
sesal	bersesal	ber-
sesal	disesalkan	di-;-kan
sesup	sesup
setel	menyetel-nyetel	meN-;R-penuh
siang	siang-siang	R-penuh
siap	disiapkannya	di-;-kan;-nya
siar	siaran	-an
siasat	persiasatan	per--an
sinar	sinaran	-an
singgung	kusinggung	ku-
sinyalir	menyinyalir	meN-
sirat	disirat	di-
spektrum	spektrumnya	-nya
studio	studio
suasana	suasananya	-nya
sudut	menyudutkannya	meN-;-kan;-nya
sulap	penyulapan	peN--an
sungguh	sungguhnya	-nya
susuk	disusuk	di-
susul	kususul	ku-
susur	menyusurinya	meN-;-i;-nya
syarikat	syarikat
tabah	tabah
tabrak	menabraknya	meN-;-nya
tahu	setahu	se-
tahu	tahu-tahunya	-nya;R-penuh
takar	takari	-i
takdir	takdirnya	-nya
takluk	ditakluk	di-
tali	tali-temali	R-penuh
tampar	bertampar-tamparan	ber--an;R-penuh
tampil	penampil	peN-
tampil	tampilkannya	-kan;-nya
tampung	tampung
tandatangan	penandatanganannya	-nya;peN--an
tanduk	tanduk
tanggulang	penanggulangan	peN--an
tanggung	tertanggungnya	ter-;-nya
tangis	tangisnyalah	-nya;-lah
tangkap	bertangkap	ber-
tangkis	tertangkis	ter-
tapak	penapakan	peN--an
tapak	pertapakan	per--an
tari	penarinya	peN-;-nya
taruh	bertaruhan	ber--an
tatal	menatal	meN-
tebal	tebalku	-ku
telepon	teleponku	-ku
teliti	ketelitian	ke--an
temeh	temeh-temeh	R-penuh
tempa	kutempa	ku-
tempa	tempa-menempa	meN-;R-penuh
tempel	ditempelnya	di-;-nya
tempuh	tempuh
temu	penemuannya	-nya;peN--an
tentang	dipertentangkannya	di-;per-;-kan;-nya
teraju	terajunya	-nya
terima	kauterima	kau-
terlantar	terlantar
ternak	ternakan	-an
tiga	tiga-tiganya	-nya;R-penuh
timbul	timbul
timbun	penimbunannya	-nya;peN--an
timpa	menimpakanmu	meN-;-kan;-mu
tinggi	setinggi-tingginya	se-;-nya;R-penuh
tiru	tirulah	-lah
tolong	penolongku	peN-;-ku
tonton	tontonkan	-kan
topeng	mempertopeng	meN-;per-
total	totalnya	-nya
transfer	transfernya	-nya
tua	ke-tua	ke-
tubuh	tubuhmu	-mu
tuding	tuding
tukang	pertukangannya	-nya;per--an
tulis	tulismu	-mu
tumpah	menumpahi	meN-;-i
tumpang	menumpangkan	meN-;-kan
tumpas	menumpas	meN-
tunduk	ditundukkannya	di-;-kan;-nya
tunggang	tunggangnya	-nya
turun	kauturunkan	kau-;-kan
tutur	kututurkan	ku-;-kan
tutur	menutur	meN-
ubat	ubat
ulang	berulang-ulangnya	ber-;-nya;R-penuh
ulang	ulang-ulanglah	-lah;R-penuh
uli	beruli	ber-
umput	berumput	ber-
umum	mengumumkan	meN-;-kan
ungkap	diungkapkannya	di-;-kan;-nya
upload	diupload	di-
urai	kuuraikan	ku-;-kan
uskup	uskup-uskup	R-penuh
utus	utusanmu	-an;-mu
valuta	valuta
versi	versi-versi	R-penuh
wangi	mewangikan	meN-;-kan
wangi	wangi-wangi	R-penuh
warga	warga-warga	R-penuh
warsawa	warsawa
wasiat	wasiatnya	-nya
waspada	mewaspadainya	meN-;-i;-nya
wenang	wenang
yah	yah
zakat	zakatkanlah	-kan;-lah
